1111111111111111
1001C00000000011
100100P0000C0011
100C00000C000011
1C010000110000C1
1C01000011000001
1101001011000C01
1C010000110000E1
1111111111111111