1111111111111
100C000P0E001
1111111111111